2021 2031 2140 2210 2230 2251 3310 3430
2021 3001 3210 2030 3051 2440 2431 3500
2021 2031 2140 2241 2251 3310 3410 2510
2021 2000 2101 2301 2210 3041 3320 3420
2121 2111 3001 3010 2230 3051 2331 2440 3530 2411 3300
2021 2030 3131 2240 2340 2441 2451 2420 2500 3201 2100 2210 2520
2121 3001 2011 2020 2231 3300 3400 2500 2520 2240 3341 3351
2121 3011 2020 2040 2230 3151 2331 2341 2520 2540 3400 2001
2021 2030 2130 2051 2240 2231 2441 3410 2500 3201 2100
2121 2010 2001 3300 2400 2510 2530 2451 2251 2341 2230 2140 2200
2021 2000 2201 3111 2400 2500 2220 2320 2420 3051 2340 2441
2021 2000 3101 2400 2211 2220 3320 2031 3041 2431
2121 2011 2200 2301 3020 3331 2051 2340 3410 3510 2441
2221 2001 2201 3400 3010 3111 2120 2230 2330 2431 2151 2351 2540
2021 2000 3111 3400 2030 2220 2141 3051 2330 2431 2540
2121 3000 2200 2410 3301 3520 2231 2241 2031 2041
2021 3011 2001 3300 2400 2420 2231 2030 2051 2240 2341
2021 2000 3101 3111 2400 3500 2031 2220 2320 2420 2340 2441
2021 2000 2101 2301 2210 2310 2411 2520 2331 3041 3051 2340
2021 2000 2101 2210 2301 2311 2500 3320 2431 2440 2251 3041