2021 2031 2140 2210 2230 2251 3310 3430
2021 3001 3210 2030 3051 2440 2431 3500
2021 2031 2140 2241 2251 3310 3410 2510
2021 2000 2101 2301 2210 3041 3320 3420
2121 2111 3001 3010 2230 3051 2331 2440 3530 2411 3300
2021 2030 3131 2240 2340 2441 2451 2420 2500 3201 2100 2210 2520
2121 3001 2011 2020 2231 3300 3400 2500 2520 2240 3341 3351
2121 3011 2020 2040 2230 3151 2331 2341 2520 2540 3400 2001